County,2000,2001,2002,2003,2004,sum
CA:_Alameda_County,809,710,757,756,685,3717
CA:_Contra_Costa_County,519,584,524,587,518,2732
CA:_Marin_County,126,143,167,149,137,722
CA:_San_Francisco_County,487,469,483,479,444,2362
CA:_San_Mateo_County,398,432,353,370,378,1931
CA:_Monterey_County,189,164,187,191,183,914
CA:_San_Benito_County,19,23,12,13,17,84
CA:_Santa_Clara_County,639,644,657,711,643,3294
CA:_Santa_Cruz_County,107,120,133,104,129,593
CA:_Los_Angeles_Registry,3986,4087,3963,3939,4004,19979
CA:_Alpine_County,1,1,0,1,0,3
CA:_Amador_County,35,40,35,40,32,182
CA:_Butte_County,193,194,193,175,182,937
CA:_Calaveras_County,41,35,41,34,39,190
CA:_Colusa_County,10,12,5,11,19,57
CA:_Del_Norte_County,24,21,23,21,26,115
CA:_El_Dorado_County,104,108,115,100,102,529
CA:_Fresno_County,367,370,364,371,402,1874
CA:_Glenn_County,21,18,18,8,21,86
CA:_Humboldt_County,91,106,104,93,108,502
CA:_Imperial_County,66,56,62,65,62,311
CA:_Inyo_County,16,16,24,16,25,97
CA:_Kern_County,357,390,356,393,389,1885
CA:_Kings_County,44,49,46,53,55,247
CA:_Lake_County,92,81,85,84,98,440
CA:_Lassen_County,9,11,21,6,10,57
CA:_Madera_County,51,83,69,65,82,350
CA:_Mariposa_County,19,19,15,21,19,93
CA:_Mendocino_County,76,82,57,52,73,340
CA:_Merced_County,100,104,98,107,92,501
CA:_Modoc_County,2,8,7,7,5,29
CA:_Mono_County,4,4,6,5,2,21
CA:_Napa_County,96,78,114,102,118,508
CA:_Nevada_County,96,86,83,77,71,413
CA:_Orange_County,1322,1356,1362,1264,1288,6592
CA:_Placer_County,175,161,200,197,183,916
CA:_Plumas_County,22,25,27,33,18,125
CA:_Riverside_County,969,944,965,1046,1048,4972
CA:_Sacramento_County,802,794,750,802,758,3906
CA:_San_Bernardino_County,839,822,792,822,833,4108
CA:_San_Diego_County,1604,1515,1510,1489,1445,7563
CA:_San_Joaquin_County,344,367,398,354,339,1802
CA:_San_Luis_Obispo_County,161,172,171,172,179,855
CA:_Santa_Barbara_County,215,194,212,196,216,1033
CA:_Shasta_County,172,146,175,178,185,856
CA:_Sierra_County,3,6,4,3,6,22
CA:_Siskiyou_County,53,43,45,40,43,224
CA:_Solano_County,235,212,242,217,221,1127
CA:_Sonoma_County,289,293,332,295,263,1472
CA:_Stanislaus_County,231,256,265,272,305,1329
CA:_Sutter_County,62,56,52,56,58,284
CA:_Tehama_County,75,79,72,48,67,341
CA:_Trinity_County,20,15,15,24,11,85
CA:_Tulare_County,157,187,172,155,196,867
CA:_Tuolumne_County,61,74,52,79,63,329
CA:_Ventura_County,380,376,351,327,371,1805
CA:_Yolo_County,92,92,72,80,106,442
CA:_Yuba_County,46,55,61,44,67,273
CT:_Fairfield_County,568,572,575,632,578,2925
CT:_Hartford_County,617,652,689,646,633,3237
CT:_Litchfield_County,127,152,157,159,155,750
CT:_Middlesex_County,135,100,125,119,124,603
CT:_New_Haven_County,626,649,717,699,704,3395
CT:_New_London_County,230,246,205,227,198,1106
CT:_Tolland_County,78,85,78,100,94,435
CT:_Windham_County,84,92,84,84,95,439
GA:_Clayton_County,110,111,99,126,118,564
GA:_Cobb_County,292,279,317,255,286,1429
GA:_DeKalb_County,330,269,269,323,290,1481
GA:_Fulton_County,428,405,428,400,393,2054
GA:_Gwinnett_County,187,270,233,218,255,1163
GA:_Glascock_County,3,1,6,7,1,18
GA:_Greene_County,13,6,18,11,16,64
GA:_Hancock_County,3,8,4,9,3,27
GA:_Jasper_County,6,6,13,17,7,49
GA:_Jefferson_County,17,17,13,11,10,68
GA:_Morgan_County,13,6,11,8,11,49
GA:_Putnam_County,16,23,20,17,15,91
GA:_Taliaferro_County,3,1,0,2,4,10
GA:_Warren_County,7,11,6,4,5,33
GA:_Washington_County,20,18,15,19,15,87
GA:_Appling_County,12,10,18,6,13,59
GA:_Atkinson_County,5,4,6,5,5,25
GA:_Bacon_County,5,8,10,10,6,39
GA:_Baker_County,1,5,1,4,1,12
GA:_Baldwin_County,44,39,32,24,35,174
GA:_Banks_County,6,9,16,8,18,57
GA:_Barrow_County,32,28,37,36,35,168
GA:_Bartow_County,76,57,73,64,57,327
GA:_Ben_Hill_County,25,20,19,17,18,99
GA:_Berrien_County,15,11,15,15,17,73
GA:_Bibb_County,115,109,124,128,122,598
GA:_Bleckley_County,9,11,16,7,11,54
GA:_Brantley_County,11,10,12,14,19,66
GA:_Brooks_County,19,17,15,17,9,77
GA:_Bryan_County,11,13,15,25,15,79
GA:_Bulloch_County,22,28,25,40,38,153
GA:_Burke_County,13,17,14,14,13,71
GA:_Butts_County,24,19,13,15,12,83
GA:_Calhoun_County,7,7,3,1,5,23
GA:_Camden_County,20,24,30,21,25,120
GA:_Candler_County,9,12,2,7,5,35
GA:_Carroll_County,69,60,71,62,64,326
GA:_Catoosa_County,49,57,58,54,50,268
GA:_Charlton_County,4,10,9,7,7,37
GA:_Chatham_County,209,173,169,195,181,927
GA:_Chattahoochee_County,2,1,3,6,5,17
GA:_Chattooga_County,20,29,23,26,26,124
GA:_Cherokee_County,75,102,76,96,90,439
GA:_Clarke_County,43,44,38,55,45,225
GA:_Clay_County,3,5,1,2,3,14
GA:_Clinch_County,9,8,9,5,6,37
GA:_Coffee_County,29,26,33,25,35,148
GA:_Colquitt_County,39,30,36,44,35,184
GA:_Columbia_County,46,56,54,72,66,294
GA:_Cook_County,8,11,5,9,12,45
GA:_Coweta_County,62,63,64,69,69,327
GA:_Crawford_County,5,14,14,13,9,55
GA:_Crisp_County,19,25,14,23,14,95
GA:_Dade_County,15,15,11,19,13,73
GA:_Dawson_County,10,12,14,13,18,67
GA:_Decatur_County,17,25,22,25,20,109
GA:_Dodge_County,10,14,20,27,9,80
GA:_Dooly_County,7,8,10,14,15,54
GA:_Dougherty_County,73,61,86,82,75,377
GA:_Douglas_County,67,65,60,62,66,320
GA:_Early_County,10,19,7,9,11,56
GA:_Echols_County,2,6,2,3,3,16
GA:_Effingham_County,31,23,24,31,21,130
GA:_Elbert_County,15,23,17,11,22,88
GA:_Emanuel_County,13,21,20,17,22,93
GA:_Evans_County,13,9,10,9,8,49
GA:_Fannin_County,24,23,32,19,23,121
GA:_Fayette_County,44,49,51,45,73,262
GA:_Floyd_County,78,76,89,100,79,422
GA:_Forsyth_County,56,49,54,52,61,272
GA:_Franklin_County,16,19,21,14,16,86
GA:_Gilmer_County,19,22,25,13,24,103
GA:_Glynn_County,61,50,72,73,61,317
GA:_Gordon_County,37,40,29,44,50,200
GA:_Grady_County,14,18,21,19,21,93
GA:_Habersham_County,25,32,31,33,27,148
GA:_Hall_County,84,78,85,98,90,435
GA:_Haralson_County,24,26,30,18,33,131
GA:_Harris_County,17,13,14,21,19,84
GA:_Hart_County,27,21,22,29,23,122
GA:_Heard_County,8,11,9,16,10,54
GA:_Henry_County,64,72,90,94,78,398
GA:_Houston_County,62,85,92,75,86,400
GA:_Irwin_County,7,10,8,9,7,41
GA:_Jackson_County,33,32,36,36,31,168
GA:_Jeff_Davis_County,11,16,15,16,9,67
GA:_Jenkins_County,10,9,8,7,7,41
GA:_Johnson_County,10,6,3,6,3,28
GA:_Jones_County,15,13,12,17,21,78
GA:_Lamar_County,15,13,6,17,17,68
GA:_Lanier_County,8,5,11,9,8,41
GA:_Laurens_County,30,34,39,39,48,190
GA:_Lee_County,12,12,13,13,15,65
GA:_Liberty_County,22,18,29,27,25,121
GA:_Lincoln_County,5,11,15,4,7,42
GA:_Long_County,5,7,4,6,4,26
GA:_Lowndes_County,59,81,66,66,54,326
GA:_Lumpkin_County,12,18,25,23,21,99
GA:_McDuffie_County,24,19,22,15,18,98
GA:_McIntosh_County,14,13,11,11,7,56
GA:_Macon_County,11,10,12,11,12,56
GA:_Madison_County,23,19,21,32,20,115
GA:_Marion_County,3,2,5,7,5,22
GA:_Meriwether_County,13,11,20,23,27,94
GA:_Miller_County,9,2,10,6,12,39
GA:_Mitchell_County,23,24,23,23,22,115
GA:_Monroe_County,15,14,16,18,11,74
GA:_Montgomery_County,6,8,5,7,4,30
GA:_Murray_County,40,31,29,42,40,182
GA:_Muscogee_County,129,136,136,149,135,685
GA:_Newton_County,43,41,59,56,55,254
GA:_Oconee_County,15,14,10,10,13,62
GA:_Oglethorpe_County,9,10,15,13,7,54
GA:_Paulding_County,42,54,44,54,49,243
GA:_Peach_County,18,17,13,20,18,86
GA:_Pickens_County,21,21,26,26,28,122
GA:_Pierce_County,15,15,8,27,18,83
GA:_Pike_County,7,8,10,7,10,42
GA:_Polk_County,31,40,54,52,32,209
GA:_Pulaski_County,5,10,12,2,5,34
GA:_Quitman_County,2,4,7,6,4,23
GA:_Rabun_County,18,15,19,13,15,80
GA:_Randolph_County,6,5,6,4,4,25
GA:_Richmond_County,153,162,163,141,148,767
GA:_Rockdale_County,38,59,50,46,42,235
GA:_Schley_County,4,1,5,2,3,15
GA:_Screven_County,10,14,20,14,12,70
GA:_Seminole_County,6,7,9,6,13,41
GA:_Spalding_County,49,47,42,40,47,225
GA:_Stephens_County,23,23,28,16,20,110
GA:_Stewart_County,4,1,5,4,7,21
GA:_Sumter_County,28,22,17,15,22,104
GA:_Talbot_County,1,5,4,7,6,23
GA:_Tattnall_County,13,27,27,14,14,95
GA:_Taylor_County,6,5,7,4,8,30
GA:_Telfair_County,8,6,8,13,12,47
GA:_Terrell_County,10,18,13,9,13,63
GA:_Thomas_County,39,49,43,26,50,207
GA:_Tift_County,26,31,35,23,17,132
GA:_Toombs_County,32,20,21,21,21,115
GA:_Towns_County,14,15,9,15,24,77
GA:_Treutlen_County,3,7,6,5,7,28
GA:_Troup_County,60,41,51,35,47,234
GA:_Turner_County,13,7,8,10,4,42
GA:_Twiggs_County,9,7,8,10,8,42
GA:_Union_County,18,17,20,26,21,102
GA:_Upson_County,30,25,17,27,24,123
GA:_Walker_County,76,82,78,89,76,401
GA:_Walton_County,33,49,38,41,54,215
GA:_Ware_County,31,44,27,23,32,157
GA:_Wayne_County,19,22,24,43,22,130
GA:_Webster_County,4,2,1,0,5,12
GA:_Wheeler_County,6,0,3,1,7,17
GA:_White_County,21,27,18,11,19,96
GA:_Whitfield_County,82,63,76,72,94,387
GA:_Wilcox_County,11,14,8,8,4,45
GA:_Wilkes_County,10,17,14,11,12,64
GA:_Wilkinson_County,8,17,12,11,9,57
GA:_Worth_County,24,14,23,21,26,108
HI:_Hawaii_County,89,90,98,103,104,484
HI:_Honolulu_County,464,439,493,490,553,2439
HI:_Kalawao_County,0,0,0,2,0,2
HI:_Kauai_County,35,25,29,30,49,168
HI:_Maui_County,65,63,64,83,68,343
ID:_Ada_County,155,142,146,189,170,802
ID:_Adams_County,1,3,3,3,3,13
ID:_Bannock_County,22,18,32,37,29,138
ID:_Bear_Lake_County,0,0,0,2,3,5
ID:_Benewah_County,8,6,8,9,9,40
ID:_Bingham_County,13,11,18,9,9,60
ID:_Blaine_County,2,10,6,5,3,26
ID:_Boise_County,4,1,4,5,9,23
ID:_Bonner_County,29,30,29,31,30,149
ID:_Bonneville_County,29,33,21,34,36,153
ID:_Boundary_County,6,9,7,9,7,38
ID:_Butte_County,2,1,2,2,5,12
ID:_Camas_County,1,0,0,1,0,2
ID:_Canyon_County,61,71,60,79,86,357
ID:_Caribou_County,3,0,3,2,1,9
ID:_Cassia_County,6,7,8,13,3,37
ID:_Clark_County,0,0,3,0,0,3
ID:_Clearwater_County,3,6,10,6,10,35
ID:_Custer_County,4,2,2,2,4,14
ID:_Elmore_County,20,9,13,13,19,74
ID:_Franklin_County,3,3,0,0,1,7
ID:_Fremont_County,5,5,8,3,4,25
ID:_Gem_County,14,15,11,18,14,72
ID:_Gooding_County,5,4,17,10,12,48
ID:_Idaho_County,9,8,16,6,9,48
ID:_Jefferson_County,8,1,2,4,7,22
ID:_Jerome_County,12,5,12,5,11,45
ID:_Kootenai_County,90,80,54,74,90,388
ID:_Latah_County,12,9,15,7,14,57
ID:_Lemhi_County,11,5,7,8,7,38
ID:_Lewis_County,6,3,3,10,6,28
ID:_Lincoln_County,5,2,2,4,4,17
ID:_Madison_County,7,2,3,2,3,17
ID:_Minidoka_County,10,7,9,10,9,45
ID:_Nez_Perce_County,42,28,43,43,42,198
ID:_Oneida_County,0,0,1,0,6,7
ID:_Owyhee_County,7,5,8,9,6,35
ID:_Payette_County,22,11,16,10,15,74
ID:_Power_County,2,1,4,1,2,10
ID:_Shoshone_County,19,19,23,22,13,96
ID:_Teton_County,2,2,1,0,2,7
ID:_Twin_Falls_County,55,46,42,44,44,231
ID:_Valley_County,9,4,6,8,4,31
ID:_Washington_County,18,8,5,13,14,58
IL:_Adams_County,72,63,74,59,66,334
IL:_Alexander_County,14,7,11,21,20,73
IL:_Bond_County,16,21,20,22,18,97
IL:_Boone_County,25,21,31,33,35,145
IL:_Brown_County,2,3,7,8,4,24
IL:_Bureau_County,37,37,38,35,32,179
IL:_Calhoun_County,7,7,7,11,0,32
IL:_Carroll_County,19,23,21,15,23,101
IL:_Cass_County,16,9,17,11,14,67
IL:_Champaign_County,93,111,91,117,101,513
IL:_Christian_County,46,52,48,52,55,253
IL:_Clark_County,13,21,15,16,11,76
IL:_Clay_County,6,19,19,15,14,73
IL:_Clinton_County,35,23,27,29,23,137
IL:_Coles_County,42,52,49,39,36,218
IL:_Cook_County,3529,3496,3598,3532,3525,17680
IL:_Crawford_County,7,18,14,17,21,77
IL:_Cumberland_County,8,11,13,10,13,55
IL:_DeKalb_County,42,56,41,46,42,227
IL:_De_Witt_County,22,16,16,24,16,94
IL:_Douglas_County,14,17,24,9,21,85
IL:_DuPage_County,463,512,466,480,489,2410
IL:_Edgar_County,25,21,20,17,18,101
IL:_Edwards_County,8,7,10,9,9,43
IL:_Effingham_County,22,26,31,31,28,138
IL:_Fayette_County,19,19,16,24,21,99
IL:_Ford_County,19,15,8,12,14,68
IL:_Franklin_County,62,35,56,53,55,261
IL:_Fulton_County,31,50,50,43,36,210
IL:_Gallatin_County,5,11,10,4,10,40
IL:_Greene_County,19,20,20,19,11,89
IL:_Grundy_County,32,21,30,25,35,143
IL:_Hamilton_County,10,9,8,10,13,50
IL:_Hancock_County,24,14,21,18,19,96
IL:_Hardin_County,6,5,7,9,10,37
IL:_Henderson_County,9,11,8,10,9,47
IL:_Henry_County,37,46,49,48,37,217
IL:_Iroquois_County,31,26,24,26,21,128
IL:_Jackson_County,30,25,40,38,30,163
IL:_Jasper_County,16,11,10,12,8,57
IL:_Jefferson_County,40,33,31,46,36,186
IL:_Jersey_County,10,18,11,20,21,80
IL:_Jo_Daviess_County,20,19,22,13,17,91
IL:_Johnson_County,14,15,6,6,15,56
IL:_Kane_County,190,216,216,226,216,1064
IL:_Kankakee_County,108,88,92,108,81,477
IL:_Kendall_County,28,33,32,33,35,161
IL:_Knox_County,46,73,65,56,72,312
IL:_Lake_County,314,331,369,383,347,1744
IL:_La_Salle_County,109,119,113,134,114,589
IL:_Lawrence_County,12,19,22,23,11,87
IL:_Lee_County,33,21,32,35,37,158
IL:_Livingston_County,29,29,33,38,39,168
IL:_Logan_County,19,23,31,24,19,116
IL:_McDonough_County,27,21,24,15,16,103
IL:_McHenry_County,121,127,164,163,152,727
IL:_McLean_County,63,85,79,92,77,396
IL:_Macon_County,111,100,127,130,148,616
IL:_Macoupin_County,44,38,57,62,61,262
IL:_Madison_County,255,232,255,244,228,1214
IL:_Marion_County,44,44,47,56,42,233
IL:_Marshall_County,8,14,17,9,14,62
IL:_Mason_County,16,19,24,20,14,93
IL:_Massac_County,15,17,20,11,14,77
IL:_Menard_County,12,12,8,11,12,55
IL:_Mercer_County,13,14,16,15,11,69
IL:_Monroe_County,14,22,14,16,21,87
IL:_Montgomery_County,34,24,30,32,26,146
IL:_Morgan_County,39,38,40,37,23,177
IL:_Moultrie_County,11,14,13,9,14,61
IL:_Ogle_County,28,50,47,38,38,201
IL:_Peoria_County,148,167,181,175,172,843
IL:_Perry_County,16,22,22,17,34,111
IL:_Piatt_County,17,7,19,15,14,72
IL:_Pike_County,25,18,17,21,11,92
IL:_Pope_County,5,3,1,7,4,20
IL:_Pulaski_County,8,10,6,3,10,37
IL:_Putnam_County,6,13,7,3,8,37
IL:_Randolph_County,33,25,28,26,27,139
IL:_Richland_County,14,27,13,11,17,82
IL:_Rock_Island_County,126,125,147,122,122,642
IL:_St_Clair_County,251,242,236,218,230,1177
IL:_Saline_County,35,43,36,40,32,186
IL:_Sangamon_County,157,139,169,176,169,810
IL:_Schuyler_County,9,3,4,10,3,29
IL:_Scott_County,2,5,4,5,5,21
IL:_Shelby_County,26,24,20,21,19,110
IL:_Stark_County,9,4,4,6,4,27
IL:_Stephenson_County,36,48,35,41,39,199
IL:_Tazewell_County,117,128,104,137,115,601
IL:_Union_County,17,13,21,15,22,88
IL:_Vermilion_County,76,103,103,93,101,476
IL:_Wabash_County,23,9,12,18,11,73
IL:_Warren_County,21,13,14,26,20,94
IL:_Washington_County,14,12,9,20,15,70
IL:_Wayne_County,22,15,23,16,21,97
IL:_White_County,23,26,16,27,28,120
IL:_Whiteside_County,52,54,56,61,45,268
IL:_Will_County,266,310,307,332,332,1547
IL:_Williamson_County,56,59,57,69,68,309
IL:_Winnebago_County,227,235,231,218,223,1134
IL:_Woodford_County,22,17,18,27,26,110
IA:_Adair_County,7,4,7,13,7,38
IA:_Adams_County,2,4,6,7,6,25
IA:_Allamakee_County,14,13,7,16,4,54
IA:_Appanoose_County,10,7,15,12,12,56
IA:_Audubon_County,3,6,8,5,5,27
IA:_Benton_County,16,21,14,22,17,90
IA:_Black_Hawk_County,98,91,93,88,90,460
IA:_Boone_County,26,26,11,22,28,113
IA:_Bremer_County,18,7,16,11,16,68
IA:_Buchanan_County,7,18,18,15,22,80
IA:_Buena_Vista_County,17,11,13,12,19,72
IA:_Butler_County,8,10,10,13,15,56
IA:_Calhoun_County,13,9,8,14,10,54
IA:_Carroll_County,27,21,11,16,22,97
IA:_Cass_County,10,14,9,10,13,56
IA:_Cedar_County,11,17,17,15,16,76
IA:_Cerro_Gordo_County,50,39,44,43,37,213
IA:_Cherokee_County,16,7,10,15,19,67
IA:_Chickasaw_County,10,10,10,16,12,58
IA:_Clarke_County,8,8,3,13,6,38
IA:_Clay_County,11,11,13,18,17,70
IA:_Clayton_County,19,11,14,19,9,72
IA:_Clinton_County,46,54,47,47,43,237
IA:_Crawford_County,12,10,8,15,14,59
IA:_Dallas_County,35,22,28,23,26,134
IA:_Davis_County,7,3,6,5,5,26
IA:_Decatur_County,4,3,13,4,6,30
IA:_Delaware_County,11,10,12,6,16,55
IA:_Des_Moines_County,41,50,37,67,42,237
IA:_Dickinson_County,19,13,17,23,7,79
IA:_Dubuque_County,58,74,80,70,77,359
IA:_Emmet_County,10,13,4,8,15,50
IA:_Fayette_County,20,17,14,22,16,89
IA:_Floyd_County,22,8,14,7,17,68
IA:_Franklin_County,15,3,14,14,11,57
IA:_Fremont_County,11,10,8,8,5,42
IA:_Greene_County,11,10,7,9,8,45
IA:_Grundy_County,6,11,18,8,6,49
IA:_Guthrie_County,11,16,12,5,15,59
IA:_Hamilton_County,8,20,11,17,12,68
IA:_Hancock_County,15,8,10,8,9,50
IA:_Hardin_County,13,21,12,13,20,79
IA:_Harrison_County,9,15,17,18,13,72
IA:_Henry_County,6,13,14,19,17,69
IA:_Howard_County,7,5,5,7,7,31
IA:_Humboldt_County,10,3,7,15,15,50
IA:_Ida_County,2,9,4,9,5,29
IA:_Iowa_County,12,11,13,8,15,59
IA:_Jackson_County,17,15,17,18,15,82
IA:_Jasper_County,34,40,24,37,28,163
IA:_Jefferson_County,5,9,6,16,10,46
IA:_Johnson_County,32,43,55,50,50,230
IA:_Jones_County,18,17,17,17,9,78
IA:_Keokuk_County,13,9,12,12,8,54
IA:_Kossuth_County,16,16,12,13,12,69
IA:_Lee_County,39,38,27,57,41,202
IA:_Linn_County,130,164,173,158,166,791
IA:_Louisa_County,7,8,7,12,9,43
IA:_Lucas_County,10,4,5,7,1,27
IA:_Lyon_County,7,6,5,5,9,32
IA:_Madison_County,8,7,12,12,10,49
IA:_Mahaska_County,19,16,21,22,19,97
IA:_Marion_County,25,27,22,24,23,121
IA:_Marshall_County,35,27,34,35,31,162
IA:_Mills_County,13,13,9,9,13,57
IA:_Mitchell_County,5,5,8,11,11,40
IA:_Monona_County,11,13,15,9,15,63
IA:_Monroe_County,13,6,7,11,6,43
IA:_Montgomery_County,16,14,10,14,13,67
IA:_Muscatine_County,37,37,28,37,28,167
IA:_OBrien_County,14,21,16,9,13,73
IA:_Osceola_County,6,3,3,6,8,26
IA:_Page_County,23,16,22,11,19,91
IA:_Palo_Alto_County,4,11,13,14,13,55
IA:_Plymouth_County,10,15,16,13,19,73
IA:_Pocahontas_County,10,8,4,11,6,39
IA:_Polk_County,238,260,239,261,271,1269
IA:_Pottawattamie_County,92,69,64,83,78,386
IA:_Poweshiek_County,7,12,16,14,19,68
IA:_Ringgold_County,5,2,7,7,4,25
IA:_Sac_County,9,15,12,8,13,57
IA:_Scott_County,137,118,119,132,117,623
IA:_Shelby_County,13,9,8,7,12,49
IA:_Sioux_County,13,16,13,12,10,64
IA:_Story_County,18,26,36,30,47,157
IA:_Tama_County,16,15,12,14,19,76
IA:_Taylor_County,3,5,6,10,3,27
IA:_Union_County,11,7,14,5,8,45
IA:_Van_Buren_County,7,10,8,8,6,39
IA:_Wapello_County,51,34,54,40,31,210
IA:_Warren_County,24,21,33,28,25,131
IA:_Washington_County,17,18,10,14,18,77
IA:_Wayne_County,8,5,10,9,8,40
IA:_Webster_County,39,38,43,32,39,191
IA:_Winnebago_County,5,8,6,10,9,38
IA:_Winneshiek_County,11,9,8,10,11,49
IA:_Woodbury_County,90,70,97,76,68,401
IA:_Worth_County,11,5,7,6,3,32
IA:_Wright_County,10,14,17,10,16,67
KY:_Adair_County,15,26,21,15,21,98
KY:_Allen_County,17,24,17,21,25,104
KY:_Anderson_County,19,12,15,10,29,85
KY:_Ballard_County,10,8,8,10,11,47
KY:_Barren_County,42,45,46,49,46,228
KY:_Bath_County,15,16,8,12,7,58
KY:_Bell_County,45,46,32,32,37,192
KY:_Boone_County,65,58,48,70,68,309
KY:_Bourbon_County,20,17,28,33,26,124
KY:_Boyd_County,56,58,77,57,71,319
KY:_Boyle_County,32,37,30,18,27,144
KY:_Bracken_County,11,8,14,10,12,55
KY:_Breathitt_County,26,8,22,13,23,92
KY:_Breckinridge_County,25,18,11,19,25,98
KY:_Bullitt_County,60,52,60,53,54,279
KY:_Butler_County,10,22,12,19,17,80
KY:_Caldwell_County,18,20,23,18,12,91
KY:_Calloway_County,26,31,31,24,38,150
KY:_Campbell_County,106,90,90,112,89,487
KY:_Carlisle_County,10,3,11,4,10,38
KY:_Carroll_County,14,16,15,16,11,72
KY:_Carter_County,39,35,34,24,28,160
KY:_Casey_County,15,27,11,17,26,96
KY:_Christian_County,52,47,43,55,43,240
KY:_Clark_County,38,27,43,31,37,176
KY:_Clay_County,14,25,25,31,28,123
KY:_Clinton_County,9,7,11,6,14,47
KY:_Crittenden_County,16,18,12,10,10,66
KY:_Cumberland_County,10,6,7,7,8,38
KY:_Daviess_County,104,101,108,104,103,520
KY:_Edmonson_County,15,17,15,19,22,88
KY:_Elliott_County,2,8,4,8,8,30
KY:_Estill_County,14,24,12,15,16,81
KY:_Fayette_County,177,212,201,182,206,978
KY:_Fleming_County,7,17,11,13,22,70
KY:_Floyd_County,51,70,72,85,56,334
KY:_Franklin_County,50,56,60,60,64,290
KY:_Fulton_County,13,8,5,9,12,47
KY:_Gallatin_County,8,7,13,9,8,45
KY:_Garrard_County,12,11,19,18,22,82
KY:_Grant_County,23,17,20,19,23,102
KY:_Graves_County,43,42,59,40,33,217
KY:_Grayson_County,30,27,25,22,30,134
KY:_Green_County,5,14,16,16,11,62
KY:_Greenup_County,35,50,43,36,49,213
KY:_Hancock_County,5,3,4,5,12,29
KY:_Hardin_County,80,84,85,93,105,447
KY:_Harlan_County,29,45,39,55,48,216
KY:_Harrison_County,20,16,23,12,20,91
KY:_Hart_County,24,16,22,20,18,100
KY:_Henderson_County,47,48,47,46,52,240
KY:_Henry_County,11,18,20,17,19,85
KY:_Hickman_County,5,9,7,8,5,34
KY:_Hopkins_County,55,69,58,58,59,299
KY:_Jackson_County,7,14,10,18,19,68
KY:_Jefferson_County,750,738,727,748,770,3733
KY:_Jessamine_County,30,28,36,32,32,158
KY:_Johnson_County,24,26,37,33,21,141
KY:_Kenton_County,133,133,145,180,169,760
KY:_Knott_County,30,29,16,25,16,116
KY:_Knox_County,34,52,44,48,42,220
KY:_Larue_County,10,8,17,14,13,62
KY:_Laurel_County,53,48,52,65,50,268
KY:_Lawrence_County,18,21,20,29,18,106
KY:_Lee_County,11,12,10,14,13,60
KY:_Leslie_County,12,18,16,26,16,88
KY:_Letcher_County,38,36,43,29,25,171
KY:_Lewis_County,15,18,20,13,18,84
KY:_Lincoln_County,30,32,45,25,28,160
KY:_Livingston_County,11,14,10,13,10,58
KY:_Logan_County,28,32,37,30,45,172
KY:_Lyon_County,14,9,11,9,7,50
KY:_McCracken_County,82,85,71,75,92,405
KY:_McCreary_County,27,25,25,23,33,133
KY:_McLean_County,11,15,14,14,7,61
KY:_Madison_County,55,70,48,61,61,295
KY:_Magoffin_County,15,12,16,8,15,66
KY:_Marion_County,19,16,11,15,18,79
KY:_Marshall_County,37,31,39,38,36,181
KY:_Martin_County,17,11,17,9,14,68
KY:_Mason_County,14,15,12,22,20,83
KY:_Meade_County,24,22,20,20,23,109
KY:_Menifee_County,7,7,3,4,8,29
KY:_Mercer_County,41,20,28,23,24,136
KY:_Metcalfe_County,16,16,14,15,11,72
KY:_Monroe_County,17,7,7,8,14,53
KY:_Montgomery_County,29,16,24,29,28,126
KY:_Morgan_County,6,13,12,18,14,63
KY:_Muhlenberg_County,37,45,45,43,39,209
KY:_Nelson_County,22,30,34,20,37,143
KY:_Nicholas_County,5,4,8,6,9,32
KY:_Ohio_County,30,23,27,29,33,142
KY:_Oldham_County,33,41,47,43,41,205
KY:_Owen_County,9,11,10,10,16,56
KY:_Owsley_County,9,4,6,7,6,32
KY:_Pendleton_County,13,11,14,17,14,69
KY:_Perry_County,27,61,48,51,54,241
KY:_Pike_County,77,77,102,76,78,410
KY:_Powell_County,13,19,19,8,11,70
KY:_Pulaski_County,81,57,84,64,62,348
KY:_Robertson_County,3,6,1,3,2,15
KY:_Rockcastle_County,17,16,17,26,20,96
KY:_Rowan_County,12,21,14,25,16,88
KY:_Russell_County,20,28,24,24,32,128
KY:_Scott_County,24,27,26,21,22,120
KY:_Shelby_County,26,41,41,38,30,176
KY:_Simpson_County,17,19,10,14,20,80
KY:_Spencer_County,10,9,9,6,11,45
KY:_Taylor_County,29,26,27,32,34,148
KY:_Todd_County,9,9,11,15,11,55
KY:_Trigg_County,23,15,22,16,19,95
KY:_Trimble_County,6,3,8,6,7,30
KY:_Union_County,14,22,20,12,22,90
KY:_Warren_County,83,85,70,74,72,384
KY:_Washington_County,16,3,4,7,11,41
KY:_Wayne_County,22,25,16,25,19,107
KY:_Webster_County,21,15,19,10,25,90
KY:_Whitley_County,46,46,39,39,55,225
KY:_Wolfe_County,20,9,11,10,9,59
KY:_Woodford_County,17,31,19,22,23,112
LA:_Acadia_Parish,42,54,53,53,52,254
LA:_Allen_Parish,13,18,16,17,22,86
LA:_Ascension_Parish,62,49,46,49,57,263
LA:_Assumption_Parish,22,24,17,11,21,95
LA:_Avoyelles_Parish,41,37,36,33,43,190
LA:_Beauregard_Parish,28,30,30,22,23,133
LA:_Bienville_Parish,11,22,17,13,13,76
LA:_Bossier_Parish,65,63,83,77,82,370
LA:_Caddo_Parish,201,214,201,233,209,1058
LA:_Calcasieu_Parish,139,141,167,164,188,799
LA:_Caldwell_Parish,13,6,9,13,10,51
LA:_Cameron_Parish,10,7,11,10,9,47
LA:_Catahoula_Parish,9,10,9,11,7,46
LA:_Claiborne_Parish,15,19,15,20,14,83
LA:_Concordia_Parish,23,19,12,19,15,88
LA:_De_Soto_Parish,17,25,22,22,22,108
LA:_East_Baton_Rouge_Parish,219,255,210,211,254,1149
LA:_East_Carroll_Parish,4,7,5,6,7,29
LA:_East_Feliciana_Parish,12,10,20,13,22,77
LA:_Evangeline_Parish,32,33,26,27,30,148
LA:_Franklin_Parish,23,20,10,24,21,98
LA:_Grant_Parish,26,14,15,18,19,92
LA:_Iberia_Parish,55,57,66,65,72,315
LA:_Iberville_Parish,19,20,28,27,35,129
LA:_Jackson_Parish,17,22,15,18,12,84
LA:_Jefferson_Parish,387,378,375,371,377,1888
LA:_Jefferson_Davis_Parish,34,28,18,34,34,148
LA:_Lafayette_Parish,119,126,131,162,124,662
LA:_Lafourche_Parish,67,51,53,66,60,297
LA:_La_Salle_Parish,11,14,11,15,14,65
LA:_Lincoln_Parish,24,16,26,36,25,127
LA:_Livingston_Parish,62,66,58,65,71,322
LA:_Madison_Parish,8,7,8,15,10,48
LA:_Morehouse_Parish,30,24,27,33,27,141
LA:_Natchitoches_Parish,28,20,34,18,33,133
LA:_Orleans_Parish,366,351,334,341,345,1737
LA:_Ouachita_Parish,121,125,98,110,101,555
LA:_Plaquemines_Parish,18,25,24,25,28,120
LA:_Pointe_Coupee_Parish,19,23,17,21,18,98
LA:_Rapides_Parish,117,101,109,100,122,549
LA:_Red_River_Parish,7,11,7,5,9,39
LA:_Richland_Parish,22,24,29,21,22,118
LA:_Sabine_Parish,34,36,25,29,23,147
LA:_St_Bernard_Parish,96,74,76,67,62,375
LA:_St_Charles_Parish,26,34,24,37,36,157
LA:_St_Helena_Parish,8,8,8,11,7,42
LA:_St_James_Parish,12,16,9,6,20,63
LA:_St_John_the_Baptist_Parish,26,23,27,30,34,140
LA:_St_Landry_Parish,79,77,67,81,75,379
LA:_St_Martin_Parish,33,33,49,48,36,199
LA:_St_Mary_Parish,40,53,37,39,41,210
LA:_St_Tammany_Parish,134,168,118,147,150,717
LA:_Tangipahoa_Parish,59,78,61,64,79,341
LA:_Tensas_Parish,8,5,9,4,4,30
LA:_Terrebonne_Parish,71,77,51,78,86,363
LA:_Union_Parish,28,21,21,18,23,111
LA:_Vermilion_Parish,40,46,45,53,52,236
LA:_Vernon_Parish,32,27,38,34,27,158
LA:_Washington_Parish,46,56,48,42,43,235
LA:_Webster_Parish,50,44,53,51,45,243
LA:_West_Baton_Rouge_Parish,13,28,14,16,13,84
LA:_West_Carroll_Parish,6,5,11,16,21,59
LA:_West_Feliciana_Parish,15,12,11,10,12,60
LA:_Winn_Parish,20,18,15,16,14,83
MA:_Barnstable_County,274,271,256,276,235,1312
MA:_Berkshire_County,143,127,125,150,126,671
MA:_Bristol_County,457,447,449,424,490,2267
MA:_Dukes_County,15,12,15,16,12,70
MA:_Essex_County,572,584,602,572,604,2934
MA:_Franklin_County,42,56,51,53,45,247
MA:_Hampden_County,322,330,347,333,352,1684
MA:_Hampshire_County,105,95,85,86,87,458
MA:_Middlesex_County,975,980,1062,1022,1023,5062
MA:_Nantucket_County,7,6,3,6,3,25
MA:_Norfolk_County,493,546,516,534,543,2632
MA:_Plymouth_County,396,411,384,386,375,1952
MA:_Suffolk_County,478,464,484,481,491,2398
MA:_Worcester_County,500,546,557,534,573,2710
NJ:_Atlantic_County,217,213,245,214,234,1123
NJ:_Bergen_County,642,661,643,615,616,3177
NJ:_Burlington_County,310,327,282,336,332,1587
NJ:_Camden_County,388,415,449,408,368,2028
NJ:_Cape_May_County,130,117,136,131,124,638
NJ:_Cumberland_County,122,111,116,124,104,577
NJ:_Essex_County,517,528,462,457,416,2380
NJ:_Gloucester_County,223,235,219,217,205,1099
NJ:_Hudson_County,362,308,329,328,315,1642
NJ:_Hunterdon_County,64,56,61,78,65,324
NJ:_Mercer_County,243,245,233,235,247,1203
NJ:_Middlesex_County,512,431,526,514,476,2459
NJ:_Monmouth_County,471,499,445,454,426,2295
NJ:_Morris_County,277,304,292,275,289,1437
NJ:_Ocean_County,586,636,691,687,644,3244
NJ:_Passaic_County,299,277,279,271,283,1409
NJ:_Salem_County,62,75,66,60,50,313
NJ:_Somerset_County,147,147,170,158,133,755
NJ:_Sussex_County,95,100,84,94,84,457
NJ:_Union_County,325,328,323,313,343,1632
NJ:_Warren_County,77,89,79,75,60,380
NM:_Bernalillo_County,246,241,261,243,256,1247
NM:_Catron_County,2,2,2,2,2,10
NM:_Chaves_County,45,32,50,52,50,229
NM:_Colfax_County,7,13,13,14,9,56
NM:_Curry_County,29,22,24,25,27,127
NM:_De_Baca_County,0,4,5,4,3,16
NM:_Dona_Ana_County,64,71,73,77,68,353
NM:_Eddy_County,45,40,36,27,38,186
NM:_Grant_County,17,15,15,15,30,92
NM:_Guadalupe_County,4,2,4,3,2,15
NM:_Harding_County,0,0,1,0,0,1
NM:_Hidalgo_County,1,3,4,2,2,12
NM:_Lea_County,53,30,31,45,40,199
NM:_Lincoln_County,9,17,11,11,13,61
NM:_Los_Alamos_County,11,5,5,4,8,33
NM:_Luna_County,22,16,21,14,12,85
NM:_McKinley_County,16,9,7,13,11,56
NM:_Mora_County,2,2,0,2,1,7
NM:_Otero_County,26,28,44,37,38,173
NM:_Quay_County,14,12,3,8,8,45
NM:_Rio_Arriba_County,14,10,15,8,10,57
NM:_Roosevelt_County,11,11,18,16,14,70
NM:_Sandoval_County,37,52,53,38,44,224
NM:_San_Juan_County,38,49,55,35,49,226
NM:_San_Miguel_County,7,9,14,10,16,56
NM:_Santa_Fe_County,48,54,36,39,42,219
NM:_Sierra_County,15,16,25,23,17,96
NM:_Socorro_County,7,7,6,8,3,31
NM:_Taos_County,8,9,9,11,14,51
NM:_Torrance_County,7,7,10,7,10,41
NM:_Union_County,2,1,3,1,5,12
NM:_CibolaValencia,32,33,46,54,58,223
NM:_Cibola_County,7,10,12,14,10,53
NM:_Valencia_County,25,23,34,40,48,170
NY:_Albany_County,258,243,246,229,247,1223
NY:_Allegany_County,38,54,40,46,41,219
NY:_Bronx_County,625,593,600,647,604,3069
NY:_Broome_County,218,157,178,174,177,904
NY:_Cattaraugus_County,90,83,61,65,60,359
NY:_Cayuga_County,57,76,72,77,75,357
NY:_Chautauqua_County,104,106,129,129,122,590
NY:_Chemung_County,93,79,101,83,90,446
NY:_Chenango_County,35,31,49,43,34,192
NY:_Clinton_County,76,69,57,79,68,349
NY:_Columbia_County,45,58,63,72,67,305
NY:_Cortland_County,40,37,33,29,47,186
NY:_Delaware_County,57,44,56,35,45,237
NY:_Dutchess_County,172,188,213,226,224,1023
NY:_Erie_County,901,875,830,845,885,4336
NY:_Essex_County,36,32,38,39,34,179
NY:_Franklin_County,48,53,43,39,35,218
NY:_Fulton_County,62,56,62,61,62,303
NY:_Genesee_County,62,57,49,56,42,266
NY:_Greene_County,43,48,48,49,50,238
NY:_Hamilton_County,5,10,10,12,9,46
NY:_Herkimer_County,66,59,60,57,66,308
NY:_Jefferson_County,96,87,85,84,89,441
NY:_Kings_County,1176,1146,1184,1123,1150,5779
NY:_Lewis_County,11,20,13,18,23,85
NY:_Livingston_County,38,37,60,52,44,231
NY:_Madison_County,67,48,65,65,47,292
NY:_Monroe_County,498,478,487,519,510,2492
NY:_Montgomery_County,51,51,46,46,49,243
NY:_Nassau_County,1023,1095,981,1016,1018,5133
NY:_New_York_County,922,951,873,896,921,4563
NY:_Niagara_County,196,232,229,235,246,1138
NY:_Oneida_County,219,230,218,199,236,1102
NY:_Onondaga_County,388,405,408,429,428,2058
NY:_Ontario_County,70,71,87,95,80,403
NY:_Orange_County,221,225,193,246,245,1130
NY:_Orleans_County,30,35,31,39,24,159
NY:_Oswego_County,111,94,130,117,110,562
NY:_Otsego_County,58,54,41,56,55,264
NY:_Putnam_County,79,68,76,72,71,366
NY:_Queens_County,1195,1191,1232,1130,1149,5897
NY:_Rensselaer_County,150,127,143,147,137,704
NY:_Richmond_County,334,304,335,302,333,1608
NY:_Rockland_County,169,162,185,193,167,876
NY:_St_Lawrence_County,99,112,104,115,107,537
NY:_Saratoga_County,150,138,159,164,173,784
NY:_Schenectady_County,135,118,135,149,110,647
NY:_Schoharie_County,35,31,41,24,28,159
NY:_Schuyler_County,12,20,14,21,20,87
NY:_Seneca_County,37,35,25,41,28,166
NY:_Steuben_County,99,86,93,76,112,466
NY:_Suffolk_County,1056,1022,1141,1104,1131,5454
NY:_Sullivan_County,65,91,58,80,75,369
NY:_Tioga_County,43,39,36,28,41,187
NY:_Tompkins_County,49,49,46,43,51,238
NY:_Ulster_County,146,151,153,148,155,753
NY:_Warren_County,61,50,55,64,58,288
NY:_Washington_County,69,45,64,54,55,287
NY:_Wayne_County,58,75,93,70,66,362
NY:_Westchester_County,655,580,599,606,641,3081
NY:_Wyoming_County,27,26,35,34,32,154
NY:_Yates_County,22,19,31,22,22,116
TX:_Anderson_County,43,32,46,38,37,196
TX:_Andrews_County,14,11,7,16,10,58
TX:_Angelina_County,68,52,83,84,86,373
TX:_Aransas_County,31,36,41,36,30,174
TX:_Archer_County,4,4,6,5,7,26
TX:_Armstrong_County,1,1,2,2,0,6
TX:_Atascosa_County,25,25,25,23,22,120
TX:_Austin_County,15,24,18,18,19,94
TX:_Bailey_County,2,6,6,1,3,18
TX:_Bandera_County,19,11,16,15,8,69
TX:_Bastrop_County,38,32,47,44,57,218
TX:_Baylor_County,5,5,8,6,9,33
TX:_Bee_County,14,19,17,19,16,85
TX:_Bell_County,161,142,153,128,164,748
TX:_Bexar_County,684,658,680,664,666,3352
TX:_Blanco_County,13,5,6,6,12,42
TX:_Borden_County,0,1,1,0,1,3
TX:_Bosque_County,24,29,17,19,10,99
TX:_Bowie_County,92,78,86,102,110,468
TX:_Brazoria_County,163,158,171,160,163,815
TX:_Brazos_County,50,46,68,59,49,272
TX:_Brewster_County,4,10,5,5,5,29
TX:_Briscoe_County,1,1,0,1,1,4
TX:_Brooks_County,6,2,1,5,6,20
TX:_Brown_County,35,32,41,40,30,178
TX:_Burleson_County,19,22,15,9,19,84
TX:_Burnet_County,28,31,34,35,37,165
TX:_Caldwell_County,19,21,24,28,26,118
TX:_Calhoun_County,13,12,13,27,18,83
TX:_Callahan_County,14,17,12,15,13,71
TX:_Cameron_County,118,115,136,144,136,649
TX:_Camp_County,14,10,10,9,7,50
TX:_Carson_County,5,2,6,4,4,21
TX:_Cass_County,21,26,22,26,35,130
TX:_Castro_County,7,2,1,2,4,16
TX:_Chambers_County,21,21,20,19,22,103
TX:_Cherokee_County,41,34,41,43,52,211
TX:_Childress_County,4,10,7,8,7,36
TX:_Clay_County,6,8,18,14,8,54
TX:_Cochran_County,3,1,1,4,1,10
TX:_Coke_County,3,5,2,4,5,19
TX:_Coleman_County,14,14,14,15,7,64
TX:_Collin_County,153,194,193,214,229,983
TX:_Collingsworth_County,3,3,2,2,4,14
TX:_Colorado_County,17,16,10,12,15,70
TX:_Comal_County,55,52,62,43,51,263
TX:_Comanche_County,14,11,18,12,16,71
TX:_Concho_County,3,3,3,0,1,10
TX:_Cooke_County,39,30,37,30,30,166
TX:_Coryell_County,30,39,34,32,42,177
TX:_Cottle_County,3,3,2,1,3,12
TX:_Crane_County,1,3,3,5,4,16
TX:_Crockett_County,2,2,0,3,2,9
TX:_Crosby_County,5,2,4,7,6,24
TX:_Culberson_County,2,0,2,1,2,7
TX:_Dallam_County,2,6,6,4,4,22
TX:_Dallas_County,1086,1208,1181,1142,1188,5805
TX:_Dawson_County,8,13,9,14,10,54
TX:_Deaf_Smith_County,7,7,6,8,8,36
TX:_Delta_County,5,8,5,5,3,26
TX:_Denton_County,155,157,150,190,196,848
TX:_DeWitt_County,21,21,21,24,15,102
TX:_Dickens_County,5,1,5,3,2,16
TX:_Dimmit_County,6,1,4,1,3,15
TX:_Donley_County,8,3,6,11,5,33
TX:_Duval_County,9,6,9,4,3,31
TX:_Eastland_County,18,12,23,20,27,100
TX:_Ector_County,90,99,90,98,85,462
TX:_Edwards_County,1,3,2,4,2,12
TX:_Ellis_County,50,70,81,105,87,393
TX:_El_Paso_County,258,244,253,247,264,1266
TX:_Erath_County,19,17,21,31,29,117
TX:_Falls_County,20,13,16,24,27,100
TX:_Fannin_County,37,26,36,25,43,167
TX:_Fayette_County,23,9,22,19,24,97
TX:_Fisher_County,4,2,5,8,3,22
TX:_Floyd_County,1,5,4,5,3,18
TX:_Foard_County,0,2,1,0,0,3
TX:_Fort_Bend_County,125,161,128,137,147,698
TX:_Franklin_County,10,18,7,12,10,57
TX:_Freestone_County,15,20,20,19,21,95
TX:_Frio_County,4,7,4,6,7,28
TX:_Gaines_County,3,6,8,6,10,33
TX:_Galveston_County,221,177,239,212,230,1079
TX:_Garza_County,4,5,6,4,3,22
TX:_Gillespie_County,29,21,19,24,31,124
TX:_Glasscock_County,1,0,0,0,0,1
TX:_Goliad_County,5,11,9,7,3,35
TX:_Gonzales_County,10,13,11,15,16,65
TX:_Gray_County,31,19,20,27,25,122
TX:_Grayson_County,110,136,106,110,119,581
TX:_Gregg_County,119,105,107,108,93,532
TX:_Grimes_County,16,18,18,19,20,91
TX:_Guadalupe_County,64,67,63,59,66,319
TX:_Hale_County,14,25,13,29,15,96
TX:_Hall_County,3,4,6,3,3,19
TX:_Hamilton_County,14,7,6,10,13,50
TX:_Hansford_County,5,3,2,1,3,14
TX:_Hardeman_County,6,1,3,4,2,16
TX:_Hardin_County,46,49,41,50,46,232
TX:_Harris_County,1639,1642,1656,1773,1700,8410
TX:_Harrison_County,68,53,50,50,43,264
TX:_Hartley_County,2,5,7,3,3,20
TX:_Haskell_County,8,2,7,5,10,32
TX:_Hays_County,36,36,38,38,54,202
TX:_Hemphill_County,4,1,2,2,2,11
TX:_Henderson_County,87,105,103,111,124,530
TX:_Hidalgo_County,194,185,186,201,169,935
TX:_Hill_County,32,41,33,42,34,182
TX:_Hockley_County,20,11,17,17,12,77
TX:_Hood_County,42,53,39,61,47,242
TX:_Hopkins_County,26,32,30,29,36,153
TX:_Houston_County,24,28,30,23,20,125
TX:_Howard_County,22,24,29,26,24,125
TX:_Hudspeth_County,2,3,1,1,0,7
TX:_Hunt_County,65,77,60,82,68,352
TX:_Hutchinson_County,26,23,15,16,24,104
TX:_Irion_County,3,0,1,1,4,9
TX:_Jack_County,8,7,16,7,5,43
TX:_Jackson_County,16,12,18,15,7,68
TX:_Jasper_County,31,30,31,39,29,160
TX:_Jeff_Davis_County,0,1,0,1,2,4
TX:_Jefferson_County,187,207,212,226,237,1069
TX:_Jim_Hogg_County,2,2,3,6,2,15
TX:_Jim_Wells_County,24,18,25,15,19,101
TX:_Johnson_County,86,109,91,94,99,479
TX:_Jones_County,15,16,12,20,19,82
TX:_Karnes_County,13,8,13,6,7,47
TX:_Kaufman_County,60,70,51,73,73,327
TX:_Kendall_County,16,16,21,19,18,90
TX:_Kenedy_County,0,0,0,0,0,0
TX:_Kent_County,3,1,2,2,3,11
TX:_Kerr_County,48,53,58,49,65,273
TX:_Kimble_County,0,2,11,1,6,20
TX:_King_County,0,0,0,0,1,1
TX:_Kinney_County,3,0,1,1,2,7
TX:_Kleberg_County,15,20,21,19,29,104
TX:_Knox_County,5,3,4,1,1,14
TX:_Lamar_County,50,61,58,63,45,277
TX:_Lamb_County,5,14,13,9,8,49
TX:_Lampasas_County,14,20,10,14,23,81
TX:_La_Salle_County,0,3,1,1,3,8
TX:_Lavaca_County,14,21,15,21,24,95
TX:_Lee_County,8,6,9,21,12,56
TX:_Leon_County,17,19,26,27,18,107
TX:_Liberty_County,58,71,77,71,64,341
TX:_Limestone_County,18,27,14,19,20,98
TX:_Lipscomb_County,1,2,1,3,5,12
TX:_Live_Oak_County,13,14,6,17,9,59
TX:_Llano_County,24,35,29,19,26,133
TX:_Loving_County,0,0,0,0,0,0
TX:_Lubbock_County,145,148,147,186,138,764
TX:_Lynn_County,4,2,2,2,5,15
TX:_McCulloch_County,14,10,14,7,5,50
TX:_McLennan_County,184,161,196,176,154,871
TX:_McMullen_County,1,0,1,3,0,5
TX:_Madison_County,6,18,11,17,11,63
TX:_Marion_County,14,17,15,14,27,87
TX:_Martin_County,2,4,2,7,4,19
TX:_Mason_County,7,2,3,6,6,24
TX:_Matagorda_County,25,34,28,32,33,152
TX:_Maverick_County,12,16,15,8,10,61
TX:_Medina_County,26,17,14,21,20,98
TX:_Menard_County,3,2,3,1,1,10
TX:_Midland_County,67,79,75,95,71,387
TX:_Milam_County,20,22,20,22,27,111
TX:_Mills_County,2,2,3,5,4,16
TX:_Mitchell_County,11,10,7,12,5,45
TX:_Montague_County,20,16,18,18,21,93
TX:_Montgomery_County,202,208,232,233,252,1127
TX:_Moore_County,15,12,7,11,8,53
TX:_Morris_County,16,12,15,15,7,65
TX:_Motley_County,4,3,1,3,1,12
TX:_Nacogdoches_County,38,52,43,56,48,237
TX:_Navarro_County,49,54,44,40,45,232
TX:_Newton_County,6,10,16,15,10,57
TX:_Nolan_County,25,14,13,16,14,82
TX:_Nueces_County,185,213,201,203,192,994
TX:_Ochiltree_County,5,4,2,2,5,18
TX:_Oldham_County,0,1,1,0,1,3
TX:_Orange_County,85,91,112,91,67,446
TX:_Palo_Pinto_County,32,38,39,30,24,163
TX:_Panola_County,28,23,20,18,26,115
TX:_Parker_County,88,88,73,81,70,400
TX:_Parmer_County,2,3,4,2,2,13
TX:_Pecos_County,9,10,6,9,7,41
TX:_Polk_County,73,70,72,72,75,362
TX:_Potter_County,100,91,90,88,72,441
TX:_Presidio_County,4,1,2,1,0,8
TX:_Rains_County,12,9,8,11,16,56
TX:_Randall_County,59,72,70,64,73,338
TX:_Reagan_County,2,2,2,3,4,13
TX:_Real_County,5,2,3,3,2,15
TX:_Red_River_County,18,23,15,11,12,79
TX:_Reeves_County,2,5,12,11,5,35
TX:_Refugio_County,14,8,7,7,1,37
TX:_Roberts_County,0,0,1,0,1,2
TX:_Robertson_County,14,15,15,22,13,79
TX:_Rockwall_County,26,25,33,26,30,140
TX:_Runnels_County,8,12,7,12,9,48
TX:_Rusk_County,37,52,40,42,46,217
TX:_Sabine_County,15,17,12,17,8,69
TX:_San_Augustine_County,12,8,9,14,8,51
TX:_San_Jacinto_County,30,28,34,34,24,150
TX:_San_Patricio_County,41,58,44,49,44,236
TX:_San_Saba_County,6,4,8,2,7,27
TX:_Schleicher_County,2,2,2,1,1,8
TX:_Scurry_County,10,22,16,9,15,72
TX:_Shackelford_County,3,3,3,2,6,17
TX:_Shelby_County,32,22,26,23,20,123
TX:_Sherman_County,2,3,1,1,1,8
TX:_Smith_County,160,137,149,132,162,740
TX:_Somervell_County,4,8,3,8,3,26
TX:_Starr_County,17,19,16,16,20,88
TX:_Stephens_County,11,9,11,9,16,56
TX:_Sterling_County,0,2,0,0,0,2
TX:_Stonewall_County,3,1,0,2,1,7
TX:_Sutton_County,2,5,6,3,6,22
TX:_Swisher_County,2,7,4,5,2,20
TX:_Tarrant_County,774,831,895,898,896,4294
TX:_Taylor_County,71,94,85,85,85,420
TX:_Terrell_County,0,0,0,0,2,2
TX:_Terry_County,7,11,7,10,8,43
TX:_Throckmorton_County,0,2,2,2,2,8
TX:_Titus_County,21,22,20,15,28,106
TX:_Tom_Green_County,72,83,72,66,68,361
TX:_Travis_County,278,301,319,322,334,1554
TX:_Trinity_County,18,20,19,19,25,101
TX:_Tyler_County,21,15,27,17,24,104
TX:_Upshur_County,39,38,31,44,43,195
TX:_Upton_County,1,1,1,2,2,7
TX:_Uvalde_County,20,15,14,20,9,78
TX:_Val_Verde_County,24,19,18,18,24,103
TX:_Van_Zandt_County,42,49,50,57,49,247
TX:_Victoria_County,54,67,71,57,63,312
TX:_Walker_County,60,57,46,48,50,261
TX:_Waller_County,22,21,14,22,22,101
TX:_Ward_County,8,7,5,8,13,41
TX:_Washington_County,18,14,32,24,21,109
TX:_Webb_County,36,41,41,46,43,207
TX:_Wharton_County,31,30,32,40,37,170
TX:_Wheeler_County,3,5,2,7,7,24
TX:_Wichita_County,97,114,138,130,112,591
TX:_Wilbarger_County,13,17,13,13,12,68
TX:_Willacy_County,10,7,10,9,8,44
TX:_Williamson_County,103,119,116,140,126,604
TX:_Wilson_County,15,16,24,20,24,99
TX:_Winkler_County,9,3,6,3,6,27
TX:_Wise_County,37,26,32,32,39,166
TX:_Wood_County,47,34,39,53,47,220
TX:_Yoakum_County,4,5,3,4,5,21
TX:_Young_County,15,18,24,27,21,105
TX:_Zapata_County,3,5,2,6,10,26
TX:_Zavala_County,4,5,1,4,8,22
UT:_Beaver_County,0,6,4,2,5,17
UT:_Box_Elder_County,8,11,8,10,9,46
UT:_Cache_County,3,11,5,13,4,36
UT:_Carbon_County,8,3,9,12,8,40
UT:_Daggett_County,1,0,0,2,0,3
UT:_Davis_County,45,41,47,59,48,240
UT:_Duchesne_County,8,5,7,5,4,29
UT:_Emery_County,1,4,2,3,6,16
UT:_Garfield_County,1,3,0,1,0,5
UT:_Grand_County,10,9,2,5,7,33
UT:_Iron_County,1,5,8,9,13,36
UT:_Juab_County,0,2,1,1,2,6
UT:_Kane_County,3,1,1,2,4,11
UT:_Millard_County,1,5,2,3,2,13
UT:_Morgan_County,0,2,0,1,1,4
UT:_Piute_County,0,1,1,4,4,10
UT:_Rich_County,0,0,0,0,0,0
UT:_Salt_Lake_County,175,203,207,225,188,998
UT:_San_Juan_County,4,4,4,5,5,22
UT:_Sanpete_County,6,12,7,5,8,38
UT:_Sevier_County,11,4,6,2,8,31
UT:_Summit_County,4,4,5,6,6,25
UT:_Tooele_County,16,9,9,12,10,56
UT:_Uintah_County,8,11,9,11,14,53
UT:_Utah_County,42,37,52,42,45,218
UT:_Wasatch_County,3,5,4,1,2,15
UT:_Washington_County,33,39,25,30,40,167
UT:_Wayne_County,2,1,0,0,2,5
UT:_Weber_County,47,70,60,74,66,317
WA:_Clallam_County,80,63,82,66,95,386
WA:_Grays_Harbor_County,100,79,89,86,86,440
WA:_Island_County,62,46,56,65,58,287
WA:_Jefferson_County,21,31,28,39,24,143
WA:_King_County,1003,944,995,985,965,4892
WA:_Kitsap_County,150,176,169,165,184,844
WA:_Mason_County,60,64,61,70,71,326
WA:_Pierce_County,494,505,488,507,511,2505
WA:_San_Juan_County,14,12,5,8,9,48
WA:_Skagit_County,85,73,99,91,79,427
WA:_Snohomish_County,305,385,370,376,359,1795
WA:_Thurston_County,144,148,158,183,155,788
WA:_Whatcom_County,85,98,101,113,117,514
